//MAP CONVERTED BY dmm2tgm.py THIS HEADER COMMENT PREVENTS RECONVERSION, DO NOT REMOVE
"aH" = (
/obj/machinery/door/airlock/titanium{
	name = "Emergency Shuttle Airlock";
	color = "#cc0000"
	},
/turf/open/floor/mineral/plastitanium/red,
/area/shuttle/escape)
"bp" = (
/turf/open/floor/mineral/plastitanium,
/area/shuttle/escape)
"bU" = (
/obj/structure/chair/comfy/shuttle{
	dir = 1
	},
/obj/machinery/recharger{
	name = "wall-mounted recharger";
	pixel_x = 28
	},
/turf/open/floor/mineral/plastitanium,
/area/shuttle/escape)
"cc" = (
/obj/structure/table/glass,
/obj/machinery/chem_dispenser/drinks/beer{
	dir = 8
	},
/obj/machinery/light{
	dir = 1
	},
/turf/open/floor/mineral/plastitanium/red,
/area/shuttle/escape)
"ci" = (
/obj/structure/closet/emcloset,
/turf/open/floor/mineral/plastitanium/red,
/area/shuttle/escape)
"cs" = (
/obj/machinery/atmospherics/pipe/manifold/supply/visible,
/obj/machinery/computer/security{
	dir = 8
	},
/obj/machinery/light{
	dir = 4
	},
/turf/open/floor/plasteel/white{
	icon_state = "plaswhite_whole_alt";
	color = "#BD83AC"
	},
/area/shuttle/escape)
"dx" = (
/obj/machinery/atmospherics/pipe/simple/supply/visible{
	dir = 6
	},
/obj/structure/chair/comfy/black{
	dir = 1
	},
/turf/open/floor/plasteel/white{
	icon_state = "plaswhite_whole_alt";
	color = "#BD83AC"
	},
/area/shuttle/escape)
"dL" = (
/obj/machinery/atmospherics/pipe/simple/supply/visible{
	dir = 5
	},
/turf/open/floor/plasteel/white{
	icon_state = "plaswhite_whole_alt";
	color = "#BD83AC"
	},
/area/shuttle/escape)
"eo" = (
/obj/machinery/light,
/obj/structure/chair/comfy/shuttle{
	dir = 1
	},
/turf/open/floor/mineral/plastitanium,
/area/shuttle/escape)
"ev" = (
/obj/structure/chair/comfy/shuttle,
/obj/structure/extinguisher_cabinet{
	pixel_y = 30
	},
/turf/open/floor/mineral/plastitanium,
/area/shuttle/escape)
"fn" = (
/obj/structure/closet/boxinggloves,
/turf/open/floor/mineral/plastitanium/red,
/area/shuttle/escape)
"fN" = (
/obj/effect/spawner/structure/window/plastitanium,
/turf/open/floor/mineral/plastitanium,
/area/shuttle/escape)
"gm" = (
/obj/effect/spawner/structure/window/shuttle,
/obj/machinery/atmospherics/pipe/manifold4w/general/visible/layer1,
/turf/open/floor/plasteel/white{
	icon_state = "plaswhite_whole_alt"
	},
/area/shuttle/escape)
"gn" = (
/mob/living/simple_animal/hostile/alien/maid/barmaid,
/turf/open/floor/mineral/plastitanium/red,
/area/shuttle/escape)
"gQ" = (
/obj/machinery/atmospherics/pipe/simple/supply/visible{
	dir = 4
	},
/turf/open/floor/plasteel/white{
	icon_state = "plaswhite_whole_alt";
	color = "#BD83AC"
	},
/area/shuttle/escape)
"hr" = (
/obj/machinery/vending/boozeomat/all_access,
/turf/open/floor/mineral/plastitanium/red,
/area/shuttle/escape)
"hA" = (
/obj/machinery/light{
	dir = 1
	},
/turf/open/floor/mineral/plastitanium,
/area/shuttle/escape)
"ia" = (
/turf/closed/wall/mineral/titanium{
	color = "#323232"
	},
/area/shuttle/escape)
"il" = (
/obj/structure/table/wood/bar,
/obj/item/storage/fancy/donut_box{
	pixel_y = 6
	},
/turf/open/floor/mineral/plastitanium/red,
/area/shuttle/escape)
"is" = (
/obj/structure/chair/comfy/shuttle{
	dir = 8;
	name = "VIP Seat"
	},
/turf/open/floor/mineral/plastitanium/red,
/area/shuttle/escape)
"jv" = (
/obj/machinery/computer/atmos_alert{
	dir = 4
	},
/obj/machinery/light{
	dir = 8
	},
/turf/open/floor/mineral/plastitanium/red,
/area/shuttle/escape)
"jK" = (
/obj/machinery/door/airlock/public/glass{
	color = "#323232"
	},
/turf/open/floor/mineral/plastitanium,
/area/shuttle/escape)
"kf" = (
/obj/structure/closet/emcloset,
/obj/machinery/atmospherics/pipe/simple/general/visible/layer1,
/turf/open/floor/plasteel/white{
	icon_state = "plaswhite_whole_alt"
	},
/area/shuttle/escape)
"kD" = (
/obj/machinery/atmospherics/pipe/simple/supply/visible,
/obj/structure/table/wood/bar,
/obj/item/reagent_containers/food/snacks/burger/red,
/turf/open/floor/plasteel/white{
	icon_state = "plaswhite_whole_alt";
	color = "#BD83AC"
	},
/area/shuttle/escape)
"kM" = (
/obj/machinery/atmospherics/pipe/simple/supply/visible{
	dir = 6
	},
/obj/structure/chair/comfy/black,
/turf/open/floor/plasteel/white{
	icon_state = "plaswhite_whole_alt";
	color = "#BD83AC"
	},
/area/shuttle/escape)
"kZ" = (
/obj/machinery/atmospherics/pipe/simple/general/visible/layer1{
	dir = 9
	},
/turf/closed/wall/mineral/titanium,
/area/shuttle/escape)
"lI" = (
/obj/structure/chair/comfy/shuttle{
	dir = 8
	},
/turf/open/floor/mineral/plastitanium/red,
/area/shuttle/escape)
"lM" = (
/turf/open/floor/glass,
/area/shuttle/escape)
"mR" = (
/obj/structure/chair/comfy/shuttle{
	dir = 1
	},
/obj/machinery/light,
/turf/open/floor/mineral/plastitanium,
/area/shuttle/escape)
"mS" = (
/obj/structure/chair/comfy/shuttle{
	dir = 4
	},
/turf/open/floor/mineral/plastitanium/red,
/area/shuttle/escape)
"ns" = (
/obj/structure/table/glass,
/obj/machinery/recharger,
/obj/machinery/atmospherics/pipe/manifold4w/general/visible/layer1,
/turf/open/floor/plasteel/white{
	icon_state = "plaswhite_whole_alt"
	},
/area/shuttle/escape)
"nU" = (
/obj/structure/closet/masks,
/turf/open/floor/mineral/plastitanium/red,
/area/shuttle/escape)
"nV" = (
/obj/structure/table,
/obj/item/storage/firstaid/fire{
	pixel_x = 2;
	pixel_y = 4
	},
/turf/open/floor/mineral/plastitanium,
/area/shuttle/escape)
"nX" = (
/obj/structure/extinguisher_cabinet{
	pixel_x = -22
	},
/obj/machinery/computer/crew{
	dir = 4
	},
/obj/machinery/atmospherics/pipe/simple/general/visible/layer1{
	dir = 6
	},
/turf/open/floor/plasteel/white{
	icon_state = "plaswhite_whole_alt"
	},
/area/shuttle/escape)
"oe" = (
/obj/machinery/light{
	dir = 4
	},
/obj/machinery/atmospherics/pipe/simple/general/visible/layer1{
	dir = 8
	},
/turf/open/floor/plasteel/white{
	icon_state = "plaswhite_whole_alt"
	},
/area/shuttle/escape)
"ok" = (
/obj/structure/chair/comfy/shuttle,
/obj/machinery/light{
	dir = 1
	},
/turf/open/floor/mineral/plastitanium,
/area/shuttle/escape)
"on" = (
/obj/structure/closet/firecloset/full{
	anchored = 1
	},
/turf/open/floor/mineral/plastitanium/red,
/area/shuttle/escape)
"oA" = (
/obj/structure/chair/comfy/black{
	dir = 4
	},
/obj/machinery/light{
	dir = 1
	},
/turf/open/floor/mineral/plastitanium/red,
/area/shuttle/escape)
"pp" = (
/obj/structure/closet/emcloset,
/turf/open/floor/mineral/plastitanium,
/area/shuttle/escape)
"pw" = (
/obj/machinery/atmospherics/pipe/simple/supply/visible{
	dir = 6
	},
/obj/machinery/atmospherics/pipe/simple/general/visible/layer1{
	dir = 4
	},
/turf/open/floor/plasteel/white{
	icon_state = "plaswhite_whole_alt"
	},
/area/shuttle/escape)
"pJ" = (
/obj/structure/shuttle/engine/heater,
/obj/effect/spawner/structure/window/plastitanium,
/turf/open/floor/mineral/plastitanium,
/area/shuttle/escape)
"pS" = (
/obj/structure/table/glass,
/obj/machinery/recharger,
/obj/item/storage/firstaid/regular{
	pixel_x = 4
	},
/turf/open/floor/mineral/plastitanium/red,
/area/shuttle/escape)
"pT" = (
/obj/effect/spawner/structure/window/shuttle,
/obj/machinery/atmospherics/pipe/simple/general/visible/layer1,
/turf/open/floor/plasteel/white{
	icon_state = "plaswhite_whole_alt"
	},
/area/shuttle/escape)
"ri" = (
/obj/machinery/door/airlock/titanium{
	name = "Emergency Shuttle Airlock";
	color = "#cc0000"
	},
/obj/structure/fans/tiny,
/turf/open/floor/mineral/plastitanium/red,
/area/shuttle/escape)
"rD" = (
/obj/machinery/atmospherics/pipe/simple/general/visible/layer1{
	dir = 10
	},
/obj/item/kirbyplants/random,
/turf/open/floor/plasteel/white{
	icon_state = "plaswhite_whole_alt"
	},
/area/shuttle/escape)
"rY" = (
/obj/machinery/atmospherics/pipe/simple/general/visible/layer1{
	dir = 5
	},
/turf/open/floor/plasteel/white{
	icon_state = "plaswhite_whole_alt"
	},
/area/shuttle/escape)
"sb" = (
/obj/structure/chair/comfy/shuttle{
	dir = 8
	},
/obj/machinery/atmospherics/pipe/manifold/general/visible/layer1,
/turf/open/floor/plasteel/white{
	icon_state = "plaswhite_whole_alt"
	},
/area/shuttle/escape)
"sl" = (
/obj/structure/table,
/obj/item/storage/firstaid/o2{
	pixel_x = 6;
	pixel_y = 6
	},
/turf/open/floor/mineral/plastitanium,
/area/shuttle/escape)
"tX" = (
/obj/effect/spawner/structure/window/plastitanium,
/obj/structure/shuttle/engine/propulsion,
/turf/open/floor/mineral/plastitanium,
/area/shuttle/escape)
"ug" = (
/obj/structure/extinguisher_cabinet{
	pixel_x = 24
	},
/obj/structure/chair/comfy/shuttle{
	dir = 8
	},
/turf/open/floor/mineral/plastitanium/red,
/area/shuttle/escape)
"uv" = (
/obj/structure/chair/stool/bar{
	can_buckle = 1;
	name = "buckleable bar stool"
	},
/turf/open/floor/mineral/plastitanium/red,
/area/shuttle/escape)
"uw" = (
/obj/structure/table/wood/bar,
/obj/item/toy/cards/deck/cas{
	pixel_x = -5;
	pixel_y = 5
	},
/turf/open/floor/mineral/plastitanium/red,
/area/shuttle/escape)
"uZ" = (
/obj/machinery/atmospherics/pipe/manifold/supply/visible,
/obj/structure/chair/comfy/black{
	dir = 1
	},
/turf/open/floor/plasteel/white{
	icon_state = "plaswhite_whole_alt";
	color = "#BD83AC"
	},
/area/shuttle/escape)
"vl" = (
/obj/structure/table,
/obj/item/storage/firstaid/brute{
	pixel_x = 6;
	pixel_y = 6
	},
/obj/item/crowbar{
	pixel_x = -3;
	pixel_y = 5
	},
/turf/open/floor/mineral/plastitanium,
/area/shuttle/escape)
"vx" = (
/obj/structure/table/glass,
/obj/machinery/light,
/turf/open/floor/mineral/plastitanium/red,
/area/shuttle/escape)
"vz" = (
/obj/structure/table/glass,
/obj/machinery/chem_dispenser/drinks{
	dir = 8
	},
/turf/open/floor/mineral/plastitanium/red,
/area/shuttle/escape)
"wl" = (
/obj/structure/table/glass,
/obj/item/crowbar,
/turf/open/floor/mineral/plastitanium/red,
/area/shuttle/escape)
"wv" = (
/obj/machinery/atmospherics/pipe/simple/supply/visible{
	dir = 4
	},
/obj/structure/chair/comfy/shuttle{
	dir = 8
	},
/turf/open/floor/plasteel/white{
	icon_state = "plaswhite_whole_alt";
	color = "#BD83AC"
	},
/area/shuttle/escape)
"wJ" = (
/obj/machinery/atmospherics/pipe/simple/supply/visible{
	dir = 10
	},
/obj/structure/chair/stool/bar{
	can_buckle = 1;
	name = "buckleable bar stool"
	},
/turf/open/floor/plasteel/white{
	icon_state = "plaswhite_whole_alt";
	color = "#BD83AC"
	},
/area/shuttle/escape)
"wK" = (
/obj/machinery/atmospherics/pipe/simple/supply/visible{
	dir = 10
	},
/turf/open/floor/plasteel/white{
	icon_state = "plaswhite_whole_alt";
	color = "#BD83AC"
	},
/area/shuttle/escape)
"xl" = (
/obj/structure/extinguisher_cabinet{
	pixel_x = -22
	},
/obj/structure/chair/comfy/black,
/turf/open/floor/mineral/plastitanium/red,
/area/shuttle/escape)
"xt" = (
/obj/machinery/atmospherics/pipe/simple/supply/visible,
/obj/structure/table/wood/bar,
/obj/item/reagent_containers/food/snacks/breadslice/meat,
/obj/item/reagent_containers/food/drinks/bottle/wine{
	pixel_y = 12
	},
/turf/open/floor/plasteel/white{
	icon_state = "plaswhite_whole_alt";
	color = "#BD83AC"
	},
/area/shuttle/escape)
"yI" = (
/obj/structure/table/optable,
/turf/open/floor/mineral/plastitanium,
/area/shuttle/escape)
"yM" = (
/obj/machinery/flasher{
	id = "cockpit_flasher";
	pixel_x = 6;
	pixel_y = 24
	},
/obj/machinery/atmospherics/pipe/simple/general/visible/layer1{
	dir = 5
	},
/turf/open/floor/plasteel/white{
	icon_state = "plaswhite_whole_alt"
	},
/area/shuttle/escape)
"yX" = (
/obj/structure/closet/cardboard,
/turf/open/floor/mineral/plastitanium/red,
/area/shuttle/escape)
"yY" = (
/mob/living/simple_animal/drone/snowflake/bardrone,
/turf/open/floor/mineral/plastitanium/red,
/area/shuttle/escape)
"zv" = (
/obj/machinery/button/flasher{
	id = "shuttle_flasher";
	pixel_x = -24;
	pixel_y = -6
	},
/turf/open/floor/mineral/plastitanium,
/area/shuttle/escape)
"zE" = (
/obj/structure/chair/comfy/shuttle{
	dir = 1
	},
/turf/open/floor/mineral/plastitanium,
/area/shuttle/escape)
"AR" = (
/obj/machinery/computer/emergency_shuttle,
/obj/machinery/atmospherics/pipe/simple/general/visible/layer1{
	dir = 9
	},
/turf/open/floor/plasteel/white{
	icon_state = "plaswhite_whole_alt"
	},
/area/shuttle/escape)
"AV" = (
/obj/structure/closet/cardboard,
/obj/machinery/light,
/turf/open/floor/mineral/plastitanium/red,
/area/shuttle/escape)
"Bc" = (
/obj/machinery/light,
/obj/item/kirbyplants/random,
/turf/open/floor/mineral/plastitanium/red,
/area/shuttle/escape)
"BQ" = (
/obj/structure/table/glass,
/obj/item/coin/red,
/turf/open/floor/mineral/plastitanium/red,
/area/shuttle/escape)
"CZ" = (
/obj/machinery/computer/communications{
	dir = 8
	},
/turf/open/floor/mineral/plastitanium/red,
/area/shuttle/escape)
"DA" = (
/obj/machinery/light{
	dir = 1
	},
/obj/structure/extinguisher_cabinet{
	pixel_y = 30
	},
/turf/open/floor/mineral/plastitanium,
/area/shuttle/escape)
"DP" = (
/obj/machinery/atmospherics/pipe/simple/supply/visible{
	dir = 9
	},
/turf/closed/wall/mineral/titanium{
	color = "#BD83AC"
	},
/area/shuttle/escape)
"Eh" = (
/obj/machinery/atmospherics/pipe/manifold/general/visible/layer1{
	dir = 1
	},
/turf/closed/wall/mineral/titanium,
/area/shuttle/escape)
"Fz" = (
/obj/machinery/light,
/obj/machinery/flasher{
	id = "shuttle_flasher";
	pixel_x = -24;
	pixel_y = 6
	},
/turf/open/floor/mineral/plastitanium,
/area/shuttle/escape)
"FA" = (
/obj/machinery/atmospherics/pipe/simple/supply/visible{
	dir = 6
	},
/turf/closed/wall/mineral/titanium{
	color = "#BD83AC"
	},
/area/shuttle/escape)
"FG" = (
/obj/machinery/light{
	dir = 4;
	light_color = "#c1caff"
	},
/obj/item/kirbyplants/random,
/turf/open/floor/mineral/plastitanium,
/area/shuttle/escape)
"FR" = (
/obj/machinery/button/flasher{
	id = "cockpit_flasher";
	pixel_x = 6;
	pixel_y = -24
	},
/obj/machinery/atmospherics/pipe/simple/general/visible/layer1,
/turf/open/floor/plasteel/white{
	icon_state = "plaswhite_whole_alt"
	},
/area/shuttle/escape)
"GJ" = (
/obj/structure/table/glass,
/obj/item/storage/box/drinkingglasses{
	pixel_y = 4
	},
/turf/open/floor/mineral/plastitanium/red,
/area/shuttle/escape)
"GQ" = (
/obj/structure/chair/comfy/shuttle{
	dir = 1
	},
/turf/open/floor/mineral/plastitanium/red,
/area/shuttle/escape)
"GR" = (
/obj/item/kirbyplants/random,
/turf/open/floor/mineral/plastitanium/red,
/area/shuttle/escape)
"Hw" = (
/obj/machinery/atmospherics/pipe/simple/supply/visible{
	dir = 10
	},
/turf/closed/wall/mineral/titanium{
	color = "#BD83AC"
	},
/area/shuttle/escape)
"HS" = (
/turf/closed/wall/mineral/plastitanium/nodiagonal,
/area/shuttle/escape)
"Id" = (
/obj/structure/chair/comfy/black{
	dir = 4
	},
/turf/open/floor/mineral/plastitanium/red,
/area/shuttle/escape)
"Iq" = (
/obj/item/kirbyplants/random,
/turf/open/floor/mineral/plastitanium,
/area/shuttle/escape)
"Is" = (
/obj/structure/fans/tiny/invisible,
/turf/open/floor/glass,
/area/shuttle/escape)
"Jf" = (
/obj/machinery/light,
/turf/open/floor/mineral/plastitanium,
/area/shuttle/escape)
"Jo" = (
/obj/machinery/atmospherics/pipe/simple/supply/visible{
	dir = 9
	},
/obj/structure/chair/comfy/shuttle{
	dir = 4
	},
/obj/machinery/atmospherics/pipe/simple/general/visible/layer1{
	dir = 10
	},
/turf/open/floor/plasteel/white{
	icon_state = "plaswhite_whole_alt"
	},
/area/shuttle/escape)
"JA" = (
/obj/machinery/light{
	dir = 1
	},
/turf/open/floor/mineral/plastitanium/red,
/area/shuttle/escape)
"JR" = (
/obj/machinery/door/airlock/public/glass{
	color = "#cc0000"
	},
/turf/open/floor/mineral/plastitanium/red,
/area/shuttle/escape)
"JU" = (
/obj/machinery/atmospherics/pipe/simple/supply/visible{
	dir = 6
	},
/turf/open/floor/plasteel/white{
	icon_state = "plaswhite_whole_alt";
	color = "#BD83AC"
	},
/area/shuttle/escape)
"Mv" = (
/obj/machinery/light{
	dir = 1
	},
/obj/machinery/flasher{
	id = "shuttle_flasher";
	pixel_x = -24;
	pixel_y = 6
	},
/turf/open/floor/mineral/plastitanium,
/area/shuttle/escape)
"Nk" = (
/obj/structure/table/glass,
/turf/open/floor/mineral/plastitanium/red,
/area/shuttle/escape)
"NS" = (
/obj/machinery/atmospherics/pipe/simple/supply/visible{
	dir = 10
	},
/obj/machinery/light,
/turf/open/floor/plasteel/white{
	icon_state = "plaswhite_whole_alt";
	color = "#BD83AC"
	},
/area/shuttle/escape)
"Ou" = (
/obj/effect/spawner/structure/window/plastitanium,
/obj/structure/shuttle/engine/heater,
/turf/open/floor/mineral/plastitanium,
/area/shuttle/escape)
"OI" = (
/obj/structure/table/glass,
/obj/effect/fun_balloon/sentience/emergency_shuttle{
	group_name = "bar staff on the Emergency Escape Bar"
	},
/turf/open/floor/mineral/plastitanium/red,
/area/shuttle/escape)
"OU" = (
/obj/structure/chair/comfy/shuttle{
	desc = "A comfortable looking seat that's clearly an upgrade for a Captain.";
	dir = 1;
	name = "Captain's Chair"
	},
/turf/open/floor/mineral/plastitanium/red,
/area/shuttle/escape)
"OX" = (
/obj/machinery/atmospherics/pipe/simple/supply/visible{
	dir = 5
	},
/turf/closed/wall/mineral/titanium{
	color = "#BD83AC"
	},
/area/shuttle/escape)
"Pe" = (
/obj/item/radio/intercom{
	name = "Station Intercom (General)";
	pixel_y = -29
	},
/turf/open/floor/mineral/plastitanium/red,
/area/shuttle/escape)
"Ph" = (
/turf/open/floor/mineral/plastitanium/red,
/area/shuttle/escape)
"Pr" = (
/obj/machinery/light{
	dir = 8
	},
/turf/open/floor/mineral/plastitanium/red,
/area/shuttle/escape)
"Pw" = (
/obj/machinery/atmospherics/pipe/simple/supply/visible,
/obj/machinery/door/airlock/public/glass{
	color = "#BD83AC";
	req_access_txt = "19"
	},
/turf/open/floor/plasteel/white{
	icon_state = "plaswhite_whole_alt";
	color = "#BD83AC"
	},
/area/shuttle/escape)
"PK" = (
/obj/structure/closet/crate/internals,
/turf/open/floor/mineral/plastitanium/red,
/area/shuttle/escape)
"PU" = (
/obj/machinery/atmospherics/pipe/simple/supply/visible,
/turf/closed/wall/mineral/titanium{
	color = "#BD83AC"
	},
/area/shuttle/escape)
"Qg" = (
/obj/machinery/sleeper,
/turf/open/floor/mineral/plastitanium,
/area/shuttle/escape)
"Qo" = (
/obj/structure/bed,
/turf/open/floor/mineral/plastitanium,
/area/shuttle/escape)
"RE" = (
/obj/structure/table,
/obj/item/storage/backpack/duffelbag/med/surgery,
/obj/item/storage/backpack/duffelbag/med/surgery{
	pixel_y = 4
	},
/turf/open/floor/mineral/plastitanium,
/area/shuttle/escape)
"RZ" = (
/obj/machinery/atmospherics/pipe/simple/general/visible/layer1,
/turf/open/floor/plasteel/white{
	icon_state = "plaswhite_whole_alt"
	},
/area/shuttle/escape)
"Sf" = (
/obj/effect/spawner/structure/window/plastitanium,
/obj/structure/sign/departments/medbay/alt,
/turf/open/floor/mineral/plastitanium,
/area/shuttle/escape)
"SD" = (
/obj/structure/table/reinforced,
/obj/item/melee/baton,
/turf/open/floor/mineral/plastitanium,
/area/shuttle/escape)
"Ui" = (
/obj/machinery/door/airlock/titanium{
	name = "Emergency Shuttle Airlock";
	color = "#cc0000"
	},
/obj/docking_port/mobile/emergency{
	name = "The DreadKnotted";
	height = 44
	},
/obj/structure/fans/tiny,
/turf/open/floor/mineral/plastitanium/red,
/area/shuttle/escape)
"Uw" = (
/obj/machinery/atmospherics/pipe/manifold4w/supply,
/turf/closed/wall/mineral/titanium{
	color = "#BD83AC"
	},
/area/shuttle/escape)
"Vn" = (
/obj/machinery/atmospherics/pipe/simple/general/visible/layer1,
/turf/closed/wall/mineral/titanium,
/area/shuttle/escape)
"VZ" = (
/turf/template_noop,
/area/template_noop)
"Xc" = (
/obj/machinery/atmospherics/pipe/simple/supply/visible{
	dir = 9
	},
/turf/open/floor/plasteel/white{
	icon_state = "plaswhite_whole_alt";
	color = "#BD83AC"
	},
/area/shuttle/escape)
"Xl" = (
/obj/machinery/light{
	dir = 4;
	light_color = "#c1caff"
	},
/turf/open/floor/mineral/plastitanium/red,
/area/shuttle/escape)
"XF" = (
/obj/machinery/atmospherics/pipe/simple/supply/visible{
	dir = 4
	},
/obj/structure/chair/comfy/shuttle{
	dir = 4
	},
/turf/open/floor/plasteel/white{
	icon_state = "plaswhite_whole_alt";
	color = "#BD83AC"
	},
/area/shuttle/escape)
"XH" = (
/obj/structure/table/reinforced,
/obj/item/restraints/handcuffs,
/turf/open/floor/mineral/plastitanium,
/area/shuttle/escape)
"XW" = (
/turf/closed/wall/mineral/titanium{
	color = "#cc0000"
	},
/area/shuttle/escape)
"Yn" = (
/obj/machinery/light,
/turf/open/floor/mineral/plastitanium/red,
/area/shuttle/escape)
"Yq" = (
/obj/machinery/door/airlock/public/glass{
	color = "#323232";
	req_access_txt = "2"
	},
/turf/open/floor/mineral/plastitanium,
/area/shuttle/escape)
"YA" = (
/obj/structure/table,
/obj/item/storage/firstaid/regular{
	pixel_x = 1;
	pixel_y = 2
	},
/turf/open/floor/mineral/plastitanium,
/area/shuttle/escape)
"Zb" = (
/obj/structure/extinguisher_cabinet{
	pixel_x = -22
	},
/obj/structure/chair/comfy/shuttle{
	dir = 4
	},
/turf/open/floor/mineral/plastitanium/red,
/area/shuttle/escape)
"Zg" = (
/obj/machinery/atmospherics/pipe/simple/supply/visible,
/turf/open/floor/plasteel/white{
	icon_state = "plaswhite_whole_alt";
	color = "#BD83AC"
	},
/area/shuttle/escape)
"Zx" = (
/obj/machinery/atmospherics/pipe/simple/general/visible/layer1{
	dir = 8
	},
/turf/closed/wall/mineral/titanium,
/area/shuttle/escape)
"ZY" = (
/obj/machinery/atmospherics/pipe/simple/supply/visible{
	dir = 5
	},
/obj/structure/chair/comfy/shuttle{
	dir = 4;
	name = "VIP Seat"
	},
/turf/open/floor/plasteel/white{
	icon_state = "plaswhite_whole_alt";
	color = "#BD83AC"
	},
/area/shuttle/escape)

(1,1,1) = {"
VZ
VZ
VZ
VZ
VZ
VZ
VZ
VZ
VZ
VZ
VZ
VZ
VZ
VZ
VZ
VZ
VZ
VZ
VZ
VZ
VZ
VZ
VZ
XW
ri
XW
Ui
XW
Is
Is
Is
Is
Is
Is
Is
Is
ia
fN
ia
fN
ia
VZ
VZ
VZ
"}
(2,1,1) = {"
VZ
VZ
VZ
VZ
VZ
VZ
VZ
VZ
VZ
VZ
VZ
VZ
VZ
VZ
VZ
VZ
VZ
VZ
VZ
VZ
VZ
XW
XW
XW
Ph
Ph
Ph
XW
XW
XW
lM
lM
lM
lM
lM
ia
ia
Iq
HS
Iq
ia
ia
VZ
VZ
"}
(3,1,1) = {"
VZ
VZ
VZ
VZ
VZ
VZ
VZ
VZ
VZ
VZ
VZ
VZ
VZ
VZ
VZ
VZ
VZ
VZ
VZ
VZ
XW
XW
mS
mS
Ph
Ph
Ph
mS
mS
XW
XW
lM
lM
lM
ia
ia
Mv
bp
HS
bp
Fz
ia
ia
VZ
"}
(4,1,1) = {"
VZ
VZ
VZ
VZ
VZ
VZ
VZ
VZ
VZ
VZ
VZ
VZ
VZ
VZ
VZ
VZ
VZ
VZ
VZ
VZ
XW
GR
Ph
Ph
Ph
Ph
Ph
Ph
Ph
Ph
aH
lM
lM
fN
fN
fN
Qo
bp
HS
bp
Qo
fN
Ou
tX
"}
(5,1,1) = {"
VZ
VZ
VZ
VZ
VZ
VZ
VZ
VZ
VZ
VZ
VZ
VZ
VZ
VZ
VZ
VZ
VZ
VZ
VZ
XW
XW
Ph
Ph
lI
lI
lI
lI
lI
Ph
Ph
XW
XW
lM
fN
HS
HS
fN
jK
HS
Yq
fN
HS
pJ
tX
"}
(6,1,1) = {"
VZ
VZ
VZ
VZ
VZ
VZ
VZ
VZ
VZ
VZ
VZ
VZ
VZ
XW
XW
XW
XW
FA
DP
XW
ci
Ph
Yn
XW
XW
XW
XW
XW
JA
Ph
GQ
XW
lM
fN
fN
SD
bp
bp
zv
bp
bp
XH
Ou
tX
"}
(7,1,1) = {"
VZ
VZ
VZ
VZ
VZ
XW
XW
Zx
XW
XW
XW
XW
XW
XW
oA
Id
Ph
gQ
Ph
JR
Ph
Ph
Ph
mS
mS
mS
Zb
mS
Ph
Ph
GQ
XW
lM
lM
ia
ia
ok
bp
bp
bp
mR
ia
ia
VZ
"}
(8,1,1) = {"
VZ
VZ
VZ
XW
XW
XW
wl
Eh
kf
Ph
Pr
Ph
Ph
xl
il
uw
dx
Xc
Ph
XW
XW
Ph
Ph
Ph
Ph
Ph
Ph
Ph
Ph
Ph
XW
XW
XW
lM
lM
ia
ev
bp
bp
bp
bU
ia
VZ
VZ
"}
(9,1,1) = {"
VZ
VZ
XW
Zx
jv
nX
RZ
kZ
GR
Ph
Ph
Ph
Ph
kM
xt
kD
uZ
Ph
Ph
Bc
XW
is
Ph
Ph
Ph
Ph
Ph
Ph
Ph
Ph
JR
Ph
XW
aH
fN
ia
fN
Yq
Yq
fN
ia
ia
VZ
VZ
"}
(10,1,1) = {"
VZ
gm
gm
ns
RZ
sb
Pe
XW
Ph
Ph
JU
Zg
Zg
Xc
Ph
Ph
gQ
Ph
Ph
Ph
XW
XW
XW
fn
Ph
Ph
Ph
PK
XW
XW
XW
Ph
Pr
Ph
bp
bp
bp
bp
bp
zE
fN
VZ
VZ
VZ
"}
(11,1,1) = {"
pT
gm
gm
AR
OU
pw
Zg
Pw
Zg
Zg
Xc
Ph
Ph
Ph
Ph
Ph
wK
Zg
dL
Ph
Ph
AV
XW
XW
XW
JR
XW
XW
XW
yX
Ph
Ph
Ph
Ph
bp
bp
bp
bp
bp
eo
fN
VZ
VZ
VZ
"}
(12,1,1) = {"
VZ
gm
gm
pS
JU
Jo
FR
Vn
yM
Ph
Ph
Ph
Ph
uv
uv
uv
uv
uv
wJ
Zg
OX
XW
XW
on
Ph
Ph
Ph
nU
XW
XW
XW
Ph
Xl
Ph
bp
bp
bp
bp
bp
zE
fN
VZ
VZ
VZ
"}
(13,1,1) = {"
VZ
VZ
XW
FA
cs
CZ
Ph
XW
rD
RZ
rY
Ph
uv
Nk
Nk
Nk
OI
Nk
GJ
vx
Hw
ZY
Ph
Ph
Ph
Ph
Ph
Ph
Ph
Ph
JR
Ph
XW
XW
fN
ia
Sf
jK
jK
fN
ia
VZ
VZ
VZ
"}
(14,1,1) = {"
VZ
VZ
VZ
Uw
DP
XW
BQ
XW
ci
Ph
oe
Ph
uv
Nk
Ph
yY
gn
Ph
Ph
XW
XW
wK
dL
Ph
Ph
Ph
Ph
Ph
Ph
Ph
XW
XW
XW
VZ
VZ
ia
pp
bp
bp
Iq
ia
ia
VZ
VZ
"}
(15,1,1) = {"
VZ
VZ
VZ
VZ
VZ
XW
XW
XW
XW
XW
Zx
XW
XW
XW
cc
vz
hr
Ph
Ph
JR
Ph
Ph
gQ
lI
lI
lI
ug
lI
Ph
Ph
GQ
XW
VZ
VZ
ia
ia
DA
bp
bp
bp
Jf
ia
ia
VZ
"}
(16,1,1) = {"
VZ
VZ
VZ
VZ
VZ
VZ
VZ
VZ
VZ
VZ
VZ
VZ
VZ
XW
XW
XW
XW
XW
XW
XW
ci
Ph
NS
PU
PU
OX
XW
XW
JA
Ph
GQ
XW
VZ
fN
fN
Qg
bp
bp
YA
bp
bp
yI
Ou
tX
"}
(17,1,1) = {"
VZ
VZ
VZ
VZ
VZ
VZ
VZ
VZ
VZ
VZ
VZ
VZ
VZ
VZ
VZ
VZ
VZ
VZ
VZ
XW
XW
Ph
Ph
mS
mS
XF
mS
mS
Ph
Ph
XW
XW
VZ
fN
Qg
bp
bp
vl
nV
RE
bp
bp
pJ
tX
"}
(18,1,1) = {"
VZ
VZ
VZ
VZ
VZ
VZ
VZ
VZ
VZ
VZ
VZ
VZ
VZ
VZ
VZ
VZ
VZ
VZ
VZ
VZ
XW
GR
Ph
Ph
Ph
wK
dL
Ph
Ph
GR
XW
VZ
VZ
fN
fN
Qg
bp
bp
sl
bp
bp
yI
Ou
tX
"}
(19,1,1) = {"
VZ
VZ
VZ
VZ
VZ
VZ
VZ
VZ
VZ
VZ
VZ
VZ
VZ
VZ
VZ
VZ
VZ
VZ
VZ
VZ
XW
XW
lI
lI
Ph
Ph
gQ
lI
lI
XW
XW
VZ
VZ
VZ
ia
ia
hA
bp
bp
bp
Jf
ia
ia
VZ
"}
(20,1,1) = {"
VZ
VZ
VZ
VZ
VZ
VZ
VZ
VZ
VZ
VZ
VZ
VZ
VZ
VZ
VZ
VZ
VZ
VZ
VZ
VZ
VZ
XW
XW
XW
lI
lI
wv
XW
XW
XW
VZ
VZ
VZ
VZ
VZ
ia
ia
bp
FG
bp
ia
ia
VZ
VZ
"}
(21,1,1) = {"
VZ
VZ
VZ
VZ
VZ
VZ
VZ
VZ
VZ
VZ
VZ
VZ
VZ
VZ
VZ
VZ
VZ
VZ
VZ
VZ
VZ
VZ
VZ
XW
XW
XW
Hw
OX
VZ
VZ
VZ
VZ
VZ
VZ
VZ
VZ
ia
fN
fN
fN
ia
VZ
VZ
VZ
"}
